SO ./path_to_the_so_textureasdassa.pngl
WE ./path_to_the_we_texture
F 11,11,246
EA ./path_to_the_ea_texture 
NO ./img/file/aasd
C 255,30,100


11111
1111111
1111111111111111
100N011
11111111111111
100001
1111111