1111111111
1000000001
1010000101
10000N1001
1000000011
1111111111
